1111111111111
1PCCCCECCCCC1
1111111111111