1111111111111111111111111
10000000000000000000000C1
1000000000000000000000001
1111111111111111111111111
10000000000000000000000E1
1000000000000000000000001
10000000000000000000000P1
1111111111111111111111111