1111101111111
10010000000C1
100001111100P
100011E000001
1111111111111