1111111111
1P00000001
1000000E11
10000001C1
1111111111