1111111111
1P00000001
1000000C11
10000001E1
1111111111