111111111111111111
1P0100001100001001
1000C00010000C0001
1000C0000000CC0001
1000C00010000CE001
111111111111111111