111111
1P0001
1000X1
111111

******
*1235*
*23X5*
******