11111111111111111111111111111111111111111
1E0000000000000C00000C0000000000000000C01
10000111111111111111111111111111111010101
10000100101010100010010000000000001010101
100000000100C000000000000000000000100C001
100100000100C0000000000000000000001000001
10010000010011111111111111111111111000001
10010010010000000000000000000000001000001
10000010010000111111111111111111111000001
1P0100000100C000000000000000000000000C111
11111111111111111111111111111111111111111