1111111111111111111111111
1P0000000000C000000000001
1111111111111111111111101
1000001000100010001000101
100010001000100010001E101
1001111111111111111111101
1000000000000000000000001
1111111111111111111111111