1111111111111111111111111111111111111111111111111
1P0000000C0000000000000000000000000000000000000E1
1CCCCCCCCCCCCCCCCCCCCCCCCCCCCCCCCCCCCCCCCCCCCCCC1
1XXXXXXXXXXXXXXXXXXXXXXXXXXXXXXXXXXXXXXXXXXXXXXX1
1000000000000000000000000000000000000000000000001
1XXXXXXXXXXXXXXXXXXXXXXXXXXXXXXXXXXXXXXXXXXXXXXX1
1000000000000000000000000000000000000000000000001
1111111111111111111111111111111111111111111111111
100000000X0000000X000000X000000000000000000000001
1111111111111111111111111111111111111111111111111