1111111111111111111111111111111111111111111111111
1P00000000000001C00000000000000000000000000000001
1011111111111001111111111111111111101111111111101
1010XC1000000000000000000000000000000000000000001
1010111010111111111111001111111111111111111111111
1010000010100000000000001000000000000000000000001
1011111110101010101010101001111111111111111111001
100000001010101010101010100000000000X1C0000000001
1000000000000000000000001111111111111111111111001
1000000000000000000000000000000000000000000000001
10000000X0000000000000000000000000000000000000001
100000000000000000000000000X000000000000000000001
1000000000000000000000000000000000000000000000001
100000000X0000000XX00000X0000000000000000000000E1
1111111111111111111111111111111111111111111111111