1111111111111111111111111
1PEC000000000000000000001
10000000000000X0000000001
1000000000000000000000001
10000000C0000000000000001
1000000CXC000000000000001
10000000C00000000000000X1
1111111111111111111111111