1111111111111111111111111
1P0000000C000000000000001
11000000000000X0000000001
1X000X0000000000000000001
10000000C0000000000000001
1000000CXC000000000000001
10000000C00000000000000E1
1111111111111111111111111