1111111111111111111111111
1P0000000C00X0000000000E1
100000000000X000000000001
1111111111111111111111111