1111111111111111111111111
1P0000000C00X0000000000E1
1111111111111111111111111