1111111111111111111111111
1P0000000C0000000000000E1
1111111111111111111111111
100000000X0000000X0000001
1111111111111111111111111