1111111111111111111111111111111111111111111111111
1P0000000C0000000000000000000000000000000000000E1
100000000C000000000000000000000000000000000000001
100000000C0000000000000000XX0000000000X0000000001
1CCCCCCCCC000000000000000000000000000000000000001
1000000000000000000000000000000000000000000000001
100000000X000000000000000000000000000000000000001
1000000000000000000000000000000000000000000000001
1000000000000X0000000000000X000000000000000000001
1000000000000000000000000000000000000000000000001
1000000000000000000000000000000000000000000000001
1111111111111111111111111111111111111111111111111
100000000X0000000X000000X000000000000000000000001
1111111111111111111111111111111111111111111111111